1	2	1	2 	3 	4 	12 	13 	1 	2 	3 	4 	9 	10 	1 	2 	3	 4	 5	 6 	21 	22 	23 	24 	1 	2 	25	 26	 3	 4	 23	 24	 1	 2	 25	 26	 3 	4	 23	 24	 1	 2	 7	 8	 9	 10	 14	 15
33	34 	27	28 	3 	4 	33 	34 	33 	34 	3 	4 	11 	11 	33 	34 	3 	 4 	 29	 30	27	28	33 	34 	42 	43 	44 	 45 	 3 	 4	 46	 47	 42	 43	 44	 45	 3	4	 46	 47	 42	 43	 7	 35	 11	 11	 48	 15
1	2 	12 	13 	3 	4 	1 	2 	1	2	3 	4 	11 	11 	1 	2 	3 	 4	 49	 50	12 	13 	1 	2 	3 	4 	25 	 26 	 3 	 4	 23	 24	 3	 4	 25	 26	 3	4	 23	 24	 3	 4	 5	 6	 11	 11	 14	 15
62	63 	64 	64 	64 	64 	65 	66 	67 	68 	3 	4 	11 	11 	33 	34 	3 	 4 	 36	 37	33	34 	33 	34 	3 	4 	33 	 34 	 3	 4	 33	 34	 3	 4	 33	 34	 3	4	 31	 32	 3	 4	 36	 37	 11	 11	 17	 38
20 	20 	20 	20 	20 	20 	20 	74 	75 	76 	3 	4 	11 	11 	1 	2 	3 	 4 	 51	 52 	1 	2 	1 	2 	3 	4 	1 	 2 	 3	 4	 1	 2	 3	 4	 1	 2	 3	4	 9	 10	 3	 4	 51	 52	 11	 11	 17	 53
7	35 	33 	34 	42 	43	81 	82 	74 	83 	64 	64 	62 	63 	64 	64 	64 	 64 	 65	 66	67	68 	33 	34 	3 	4 	33 	 34 	 3 	 4	 33	 34	 3	 4	 33	 34	 3	4	 27	 28	 3	 4	 56	 57	 58	 59	 17	 69
5 	6 	1 	2 	3 	4 	21 	22 	20 	20 	20 	20 	20 	20 	20 	20 	20 	 20 	 20	 74	75	76 	1 	2 	3 	4 	1 	 2	 3	 4	 1	 2	 3	 4	 1	 2	 3	4	 12	 13	 3	 4	 72	 58	 73	 20	 20	 20
36 	37 	33 	34 	3 	4 	33 	34 	31 	32 	3 	4 	27 	28 	3 	4 	27 	 28	 81	 82	74	75	67	68 	3 	4 	33 	 34 	 3	 4	 33	 34	 3	 4	 33	 34	 3	4	 33	 34	 3	 4	 78	 73	 79	 80	 48	 15
51 	52 	1 	2 	3 	4 	1 	2 	9 	10 	3 	4 	12 	13 	3 	4 	12	 13	 21 	 22	97 	74 	75 	76 	3 	4 	1 	 2	 3	 4	 1	 2	 3	 4	 1	 2	 3	4	 1	 2	 3	 4	 20	 39	 90	 91	 14	 15
62	63 	62 	63 	60 	61 	62 	63 	62 	63 	60 	61 	62 	63 	60 	61 	62 	 63 	 62	 63	62 	63 	74 	83 	60 	61 	62 	 63	 60	 61	 62	 63	 60	 61	 62	 63	 60	61	 62	 63	 60	 61	 62	 63	 62	 63	 98	 15
20	20 	20 	20 	20 	20 	20 	20 	20 	20 	20 	20 	20 	20 	20 	20 	20 	 20	 20	 20	20	20	20 	20 	20 	20 	20 	 20	 20	 20	 20	 20	 20	 20	 20	 20	 20	20	 20	 20	 20	 20	 20	 20	 20	 20	 20	 20