16	17 	17 	17 	17 	17	 3	 4	 17	 17	 17	 17	 17	 17	 17	 17	 3	 4	 17	 17	 3	 4	 17	 17	 17	 17	 17	 17	 17	 17	 20	 20
39	17 	17 	17 	17 	17	 3	 4	 17	 17	 41	 17	 41	 17	 41	 17	 3	 4	 17	 17	 18	 19	 17	 17	 17	 17	 41	 17	 41	 17	 17	 38
39	17 	17 	40 	17 	17	 3	 4	 17	 17	 17	 17	 17	 17	 17	 17	 18	 19	 17	 17	 3	 4	 17	 17	 17	 17	 17	 17	 17	 17	 17	 53
39	17 	17 	55 	17 	17	 18	 19	 17	 17	 17	 17	 17	 17	 17	 17	 3	 4	 70	 71	 3	 4	 17	 17	 17	 17	 17	 17	 17	 17	 17	 69
20	20 	20 	20 	20 	20	 20	 20	 17	 17	 17	 17	 70	 71	 70	 71	 3	 4	 39	 77	 3	 4	 17	 17	 17	 17	 20	 20	 20	 20	 20	 20
16	17 	70 	71 	70 	71	 3	 4	 17	 17	 17	 17	 39	 77	 39	 77	 86	 87	 86	 87	 20	 20	 17	 17	 64	 85	 17	 17	 70	 71	 88	 89
16	17 	39 	77 	39 	77	 3	 4	 20	 20	 20	 93	 85	 17	 70	 71	 86	 87	 86	 87	 3	 4	 20	 20	 20	 93	 85	 17	 39	 77	 88	 89
16	17 	17 	17 	17 	17	 3	 4	 70	 71	 3	 4	 93	 85	 39	 77	 87	 87	 87	 87	 3	 4	 70	 71	 3	 4	 93	 85	 17	 17	 88	 89
16	17 	17 	17 	17 	17	 18	 19	 39	 77	 18	 19	 17	 93	 85	 17	 39	 87	 86	 87	 18	 19	 39	 77	 3	 4	 17	 93	 85	 17	 88	 89
16	17 	64 	85 	17 	17	 60	 61	 17	 17	 60	 61	 17	 17	 93	 94	 39	 87	 87	 87	 60	 61	 64	 85	 60	 61	 17	 17	 93	 17	 88	 89
20	20	20 	93 	20 	20 	20	 20	 20	 20	 20	 20 	 20 	 20 	 20 	 20	 87	 87	 87	 87	 20 	 20 	 20 	 93 	 20	 20	 20	 20	20	20 	20 	20	